XOOOOOOO
OXXXXXXO
OOOOOOOO
XOXOXXXX
XOXOXOOO
XOXOXOXO
XXXXXOOO
XOXOOOXO
